###########
#000###000#
#000###0000
#00#0#0000#
#00#0#0#00#
#0000#0####
#0#00##000#
#0#000000##
#0#00#0#0##
#00#000#00#
#0#########
